AKADEMIAJ KOREKTOJ
DE LA UNIVERSALA VORTARO

Okaze de la Dua Universala Kongreso (Ĝenevo, 1906), la Lingva
Komitato decidis, ke estu reviziitaj la naciaj tradukoj de la radikoj
entenataj en la Universala Vortaro fare de komisionoj franca, 
germana, angla, rusa, kaj pola (1). Fakte tiu laboro estis komencita de
la L.K. ĵam antaŭ la Ĝeneva Kongreso. Ĝi estis daŭronta ĝis 1914
kaj pro la milito estis publikigita nur en 1922-23.

En la Tria U.K. (Kembriĝo, 1907) la L.K. konstatas, ke la tri
partoj angla, germana kaj pola estas preskaŭ prespretaj; la rusa
alvenas dum la presado de la kongresa raportaro (2). Pri la franca,
Prof. Th. CART jam antaŭe publikigis partan korektoliston (1).

La komisiono pri dubaj tradukoj finas sian laboron por la Kvara
U.K. (Dresdeno, 1908), laŭ la deklaro de Prezidanto Prof. BOIRAC
en sia Raporto pri la agado de L.K. de la Tria ĝis la 
Kvara Kongresoj (3).

Tamen tiuj korektoj estis aperontaj nur ek de Aprilo 1912 en la
«Oficiala Gazeto», kaj ili tie aperis nur kiel Prepardokumentoj, kiel
anoncis Prof. CART en sia Raporto de la Vortara Sekcio (4). Krome,
la franca kaj rusa partoj anoncitaj fine de 1912 (5) aperos nur en
1913.

(1) Cirkulero 4-a de L.K., 27 OKT 06, citita de OG 1, p. 4. — Krome Vd.
la tre detalan raporton de Th. CART (1907), kiu enhavas francan tradukliston
aprobitan de ZAMENHOF kaj ankaŭ rimarkojn de la majstro pri la vortoj:
akuŝi, domaĝo, lui, ekstr, gargari; rimarkoj enprenitaj en LR 
(Kp. OV 588-539).

(2) E-ista Dok., Kajero sesa (JAN 08) p. 21 kaj p. 57.

(3) OG 1, 25 AUG 08, p. 78.

(4) OG 5, 2 (46), 25 JUL 12, p. 53.

(5) OG 5, 5 (49), 25 NOV 12, p. 167.




 

Tiel, ĉe la Naŭa U.K. (Berno, 1913), la kvin partoj jam aperis
kaj Prezidanto Prof. BOIRAC atestas (6) la ricevon de rimarkoj pri
tiuj prepardokumentoj, krom pri la pola kaj la rusa.

La konkluda raporto (datita: 14 JUL 13) de CART sub la
titolo: Oficialaj decidoj kaj komunikoj, Raporto pri dubaj tradukoj
de Universala Vortaro (7) konfirmas la antaŭajn prepardokumentojn,
sed aldonas tri listojn de modifoj: anglan, germanan kaj francan.
Tamen la partoj pola kaj rusa ŝajne estas ne tute kontentigaj kaj oni
decidas peti konfirmon de la polaj kaj rusaj L.K.-anoj antaŭ definitiva publikigo (8). Tia konfirmo sub formo de novaj korektoj venis por
la rusa ŝajne nur post 1914 kaj povis aperi nur kun la definitiva teksto
en 1923. Aliparte, restis dubo, kiel oni nun uzu tiujn korektojn? Ĉu
enpreni ilin en novan korektitan eldonon de la Fundamento?

Por la Deka U.K. (Parizo, 1914), CART pretigis Raporton de
la Sekcio pri Komuna Vortaro. Tie li parolas interalie pri la naciaj
tradukoj de Universala Vortaro (9); post la fino de tiu laboro venis
pluaj rimarkoj: «Senfina estus tia laboro, se ĉiujn klerulojn oni volus
aŭskulti». Tial li saĝe proponas: unue, ke la UV mem restu, kia ĝi
estas, t.e. sen korektoj. Due, ke la vortaristoj estu invitataj uzi 
la korektojn montritajn de la L.K. en la oficiale akceptitaj raportoj.

Pro la milito, prokrastiĝis la eldono plurajn jarojn: komence de
1921 oni repensas pri utileco de tia eldono (10), kaj en sia raporto
antaŭ la L.K. kaj ĝia Akademio (11), Prezidanto CART anoncas, ke
la listo de korektoj aperos ĉu aparte, ĉu kune kun plena Radikaro
Oficiala entenanta tradukojn, sed ke la Universala Vortaro daŭre estos
represata tia, kia ĝi estas.

Bedaŭrinde ek de 1922, ne plu aperas la «Oficiala Gazeto» kaj
la Centra Oficejo ne plu eldonas. Tio klarigas la mizeran staton, en
kiu estas eldonitaj de diversaj firmaoj la kvin broŝuroj litografitaj laŭ
manskribitaj originaloj.

(6) OG 6, 2 (57), 25 JUL 18, p. 21.

(7) OG 6, 9 (64), 25 MAR 14, p. 199-202.

(8) OG 6, 4 (59), 25 OKT 13, p. 60.

(9) OG 7, 2 (68), 25 JUL 14, p. 38.

(10) OG 8, 1-2 (78-79), 25 JAN 21 (Piednoto p. 3).

(11) OG 8, 4 (81), 25 SEPT 21, p. 106.



Ili aperas sub la ĝenerala titolo: Korekto de la eraraj tradukoj
en Universala Vortaro (kun aprobo de la Lingva Komitato). La
franca kaj angla partoj aperas sen dato, sed ŝajne en la dua duono de
1922 (12). En 1923 aperas la tri aliaj partoj. «Esperanto», organo de
U.E.A., en sia numero de Novembro 1922 (p. 190) salutas tiun longe
atenditan verkon, okaze de la apero de la franca parto kaj la recenzisto
prave rimarkas: «Eble la titolo ne estas tre bone elektita, ĉar pli ofte
ol eraraj, la tradukoj estas nesufiĉaj, neplenaj, dubaj aŭ dusencaj,
kaj la korektoj estas precizigoj, unusencigoj aŭ kompletigoj.»

Ni aldone memorigu, ke GROSJEAN-MAUPIN enprenis tiujn
korektojn en sian Oficialan Klasikan Libron (1924-27), antaŭ ol
priatenti ilin okaze de la redaktado de la Plena Vortaro (1930), verko
vaste konata kaj de multaj konsiderata kiel «duonoficiala». Tiel, 
tamen, tiuj Akademiaj Korektoj ricevis vastan diskonigon, des pli ke
la plej multaj el la bonaj naciaj vortaroj apogiĝas sur la Plena Vortaro.

Atentante la Bulonjan Deklaracion kaj la decidojn de la Lingva
Komitato, ni represis en tiu ĉi volumo la Universalan Vortaron senŝanĝa, 
kaj ĉi-sube sekvas la kvin partoj de la Korektoj. Ni represas
ilin en sia tuteco, sed tamen donas al ili la kutiman ordon de la Universala Vortaro: franca, angla, germana, rusa, pola. Krome nur la
angla kaj la germana partoj enhavis ĝeneralan titolon kaj enkondukon:
tiujn ni presas kompreneble nur unufoje kaj ĉekape.

Ni memorigu ĉi tie, ke en la marĝenoj de la Universala Vortaro
ni aldonis la litersignojn f, a, g, r, p vid-al-vide de la radikoj, por
kiuj estas trovebla Korekto en unu aŭ pluraj partoj.

                           A. A.

(12) Ke ankaŭ la angla datas el 1922, evidentas el la fakto, ke la ekz-ero,
pri kiu mi povis disponi, surhavas stampon kaj de la Brita E-o-Asocio kaj de
la dato: 3 AUG 22.



 
OFICIALA RAPORTO DE PROF. TH. CART
PRI ERARAJ NACILINGVAJ TRADUKOJ EN UV,

(1914)

Al Rektoro BOIRAC,
Prezidanto de la Lingva Komitato.

Estimata Prezidanto,

La laboro pri la nacilingvaj eraroj en la tradukoj de UV estas
finita. La korektotaj tradukoj jam aperis en «Oficiala Gazeto»
N-oj 43, 44, 46, 47, 50, 51 kaj 64. De tiam mi ricevis ankoraŭ diversajn rimarkojn, kiuj montras, kiel malfacila estas la konsento eĉ
inter samlingvanoj: senfina estus tia laboro, se ĉiujn klerulojn oni
volus aŭskulti. La Akademio ree atente ekzamenis la faritajn kritikojn kaj akceptis tiujn, kiuj post interkonsiliĝo kun la speciale
interesataj nacilingvanoj, ŝajnis aprobindaj. Tie ĉi, kiel ĉie, preferinda estas eĉ ne perfekta solvo, ol neniu solvo(*).

*) Cetere ŝajnas pli saĝe lasi, laŭ la konsilo de D-ro ZAMENHOF, nian UV
tia, kia ĝi estas (eĉ kun ĝiaj tradukeraretoj), kaj simple inviti la verkistojn de naciaj vortaroj uzi la tie ĉi montritajn korektojn. [noto en la raporto mem]



FRANCA PARTO (13) (14) (15)

A 

abon| s'abonner (à).
acid| acide, aigre.
admon| engager, exhorter.
adult| commettre un adultère.
afabl| affable, aimable.
afekt| affecter, être affecté, minauder.
afer| affaire (en  général), chose.
agac| agacement (des dents).
agord| accorder, mettre au diapason (musique).
akar| acare, mite, ciron.
akcel| accelérer, hâter.
akcept| accepter, accueillir.
akn| acné, bouton.
akr| aigre, piquant, vif, perçant, tranchant.
akuŝ| accoucher (intr.).
al. à, vers.

alk| élan (zool.).
almenaŭ. au moins, du moins.
aln | aune (bot.).
ambaŭ. l'un et l'autre, tous deux.
ampleks| dimension, étendue.
angul| angle, coin.
ankaŭ. aussi, encore.
ankoraŭ. encore, jusqu'à présent.
anonc| faire une annonce.
antaŭ. devant, avant.
antikv| antique, ancien.
apart| particulier, séparé, spécial:
artifik| artifice, subterfuge.
artikol| article (litt., gram.).
asekur| assurer (par contrat).
atripl| arroche (bot.).
avel| noisette.
avert| avertir, prévenir, détourner.
avid| avide.


 

(13) Th. CART (1922).

(14) Komparu: Prepardokumentoj: OG 5, 6 (50), 25 DEC 12, p. 210-221.
— Vd. Eratumo: OG (51), p. 226; modifojn Vd. en: OG 6, 9 (64), 25 MAR
14; p. 202. — Krome Vd. noton 1.

(15) La franca komisiono elektita de la L.K. okaze de la Ĝeneva Kongreso (1906) estis formita de S-roj DE BEAUFRONT, CART, HUET (Vd. E-ista
Dok., MAR 07, p. 36). — Horace HUET (1860-1911) estis aŭtoro de raporto
al la L.K. (1911).



B 


bak| (faire) cuire (au four).
baldaken| baldaquin, dais.
ban| baigner (trans.).
bant| nœud (de ruban).
barakt| gigoter, se débattre.
bask| basque (d'habit), pan.
bazar| bazar, marché.
bed| couche, platebande.
ber| baie (bot.).
best| animal, bête.
bien| bien, avoir, propriété.
biskvit| biscuit (pâtisserie).
blat| blatte, cafard, cancrelas.
blek| crier (en parlant des animaux), beugler, hennir, ...
bors| bourse (local).
bran| son (de grain).
brav| brave, vaillant.
bret| tablette, étagère, rayon.
briliant| brillant (diamant).
bub| gamin.
buĉ| tuer, massacrer, abattre (animaux).
bud| boutique, échoppe.
bufed| buffet, restaurant.
bukl| bouche (de cheveux).
bulb| bulbe, oignon.
bulk| petit pain blanc.
burd| bourdon (zool.).


C, Ĉ

ĉarnir| charnière, gond.
ĉe. chez, à, en présence de.
cejan| bluet.
ĉes| cesser (intr.)
ĉikan| chicaner.
cikatr| cicatrice.
cirkel| compas.
civiliz| civiliser.
col| pouce (mesure).
ĉu. est-ce que, si (inter. ind.).


D

daŭr| durer, continuer.
dec| être convenable, convenir, être séant.
dekliv| pente, rampe.
delfen| dauphin (zool.).
delikat| délicat, fin.
delir| délirer.
dev| devoir (obligation).
  dev|ig| obliger, contraindre.
dezir| désirer, souhaiter.
diboĉ| vivre dans la débauche.
didelf| didelphe, sarigue.
diferenc| différer, être différent.
dik| gros, épais.
direkt| diriger, adresser.
domaĝ| (c'est) dommage.
dres| dresser, dompter.
drink| boire (avec excès).
dung| embaucher, engager.


E

edif| édifier (moralement).
efik| operer, agir, être efficace.
el. hors de, de, d'entre, é-, ex-.
elekt| choisir, élire.
erar| faire erreur, se tromper.
esplor| explorer, rechercher, examiner.
etat| état, liste.


F 

fak| compartiment, branche, spécialité.
fam| bruit, renommée.
farm| prendre à ferme.
faŭk| gueule, orifice.
fid| se fier, compter sur, avoir foi en.
fier| fier.
figur| figurer, représenter.
fin | finir (trans.).
firm | ferme, solide.
flan | flan (pâtisserie).
fleg| soigner (un malade).
flik| rapiécer.
flos |radeau, train de bois flotté.
fokus| foyer (phys.).
fork| fourche, fourchette.
fortepian| piano (instrument).
frand| manger avec gourmandise, par friandise
fraŭl| célibataire, garçon.
front| front (milit.).
frunt| front (partie du visage).
fulm | éclair, foudre.
funt| livre (mesure de pesanteur).
fuŝ| gâcher, saboter, bâcler.


G, Ĝ

gal| bile, fiel.
galanteri| accessoires de toilette, nouveautés, colifichets.
garanti| garantir, donner des garanties, se porter garant.
gargar| rincer, gargariser.
gast| hôte, convive.
genot| genette.
golf| golfe, baie.
graci| gracieux, délié, élancé.
grav| grave, important.
grenad| grenade, obus.
groŝ| gros (monnaie), groschen
ĝu| jouir de, prendre plaisir à.
ĝust| juste, exact, correct.
guvern| gouverner, élever, éduquer un enfant.


H

hak| couper, tailler à la hache.
har| cheveu, poil.
  har|ar'| chevelure.
hejm| le chez soi, le foyer domestique.
hipokrit| feindre, faire l'hypocrite.
histrik| porc-épic.
huf| sabot (d'animal).
husar| hussard.


I

imag| s'imaginer.
indulg| être indulgent, épargner, ménager.
infekt| infecter, contaminer.
influ| influer, influencer.
infuz| (faire) infuser (trans.).
iniciat| prendre l'initiative de, provoquer.
insign| insigne, armoiries, armes.
instig| pousser à, inciter à.
instrukci| instructions, ordres.
insult| insulter, injurier.
intermit| être intermittent, avoir des intermittences.


J, Ĵ
 
ĵongl| jongler.
juglandl| noix (du noyer).
just| juste, équitable.


K

kaĉ| bouillie.
kajer'| cahier, fascicule.
kajut| cahute, cabine.
kalkul| calculer, compter.
kamer| chambre noire.
kamlot| camelot (ètoffe).
kapt| attraper, capturer, prendre, saisir.
karpen| charme (bot.).
kartoĉ| cartouche (subst. fém.).
kas| caisse (fonds).
katun| cotonnade.
kaz| cas (gram.).
kaze| fromage blanc.
kelner| garçon (d'hôtel, de café).
ker| cœur (cartes).
kil| quille (de bateau).
kitel| sarrau, blouse.
klap| clapet, soupape.
kler| cultivé, instruit.
klopod| se donner de la peine, faire des démarches.
kloŝ| cloche (pour couvrir: melon, pendule, etc.).
knab| petit garçon.
kobold| lutin, farfadet.
kolbas| saucisse, andouille.
koleg| collègue, confrère, condisciple.
komand| commander (milit.).
komenc| commencer (trans.).
komerc| faire du commerce.
komfort| confort.
komisi |charger de.
komiz| commis, employé.
komuni| donner la communion.
kondolenc| présenter ses compliments de condoléance.
konkur| rivaliser, concourir.
konsent| consentir, être d'accord.
kontrakt| faire un contrat.
kontraŭ. contre, en face de, vis-à-vis de.
kontuz| contusionner, meurtrir.
kord| corde (mus.)
korpus| corps (d'armée).
krev| crever, éclater.
kring| gimblette (pâtisserie).
krisp| fraise (anat. et costume).
krom. hors, hormis, outre, à part, indépendamment de.
krop| jabot, gésier.
kuf| coiffe, bonnet de femme.
kukurb| potiron, citrouille.
kul| cousin, moustique.
kurator| curateur, tuteur.
kurier| courrier, messager.

 kusen|eg| édredon.
kutim| avoir coutume, être habitué à.
kuv| cuve.
kviet| doux, tranquille, calme,
kvit| quitte, libéré,
kvitanc| donner quittance, acquitter.


L

laĉ| lacet, cordon.
laks| diarrhée.
las| laisser, abandonner.
lavang| avalanche.
lekant| marguerite (petite ~).
leksikon| lexique.
lentug| tache de rousseur.
lev| lever, ramasser.
libel| libellule.
liken| dartre (méd.), lichen (bot.).
lim| limite, confins, frontière.
lorn| lorgnette, longue-vue.
lu| louer, prendre en location.
lustr| lustre, suspension.


M

makler| faire le courtage.
mam| mamelle, pis, sein.
marŝal| maréchal (milit.).
mastr| maître de maison, patron.
mend| faire une commande, commander.
miks| mêler, mélanger.
min| mine, fosse.
mir| s'étonner.
mond| monde.
mops| doguin, carlin, roquet.
mustel| martre, belette.


N

nap| navet.
negliĝ| négligé (vêt.).
negoc| affaires, trafic.
nepr| immanquablement, sans faute, tout-à-fait.
net| (au) net, cahier de net.
nuks| noix (en général).


O

odor| sentir, avoir ou répandre une odeur.
orden| ordre (honorifique).
orf| orphelin (subst.).


P 

paĝi| page (subst. masc.).
paletr| palette (d'un peintre).
palp| palper, toucher, tâter.
parad| parader, faire parade.
parter| parterre (théâtre), rez-de-chaussée.
paŝ| faire des pas, marcher.
pasament| passement, galon, tresse.
paser| passereau, moineau.
paŝt| (faire) paître (trans.).
pekl| saler (pour conserver).
pel| pousser, repousser, chasser (devant soi).
pelv| bassin, vase (ustensile et anat.).
pendol| pendule (subst. masc.), balancier.
pensi| pension, retraite.
pet| prier (qqn), demander.
pice| épicéa, sapin.
piked| piquet (milit. et jeu de cartes).
pini| pin, pignon.
pint| pointe, bout, cime.
piroz| pyrosis, douleur brûlante à l'estomac, aigreurs.
plan| plan (subst. masc.), projet.
plaŭd| clapoter, battre.
plend| se plaindre.
plet| plateau (ustensile).
pli. plus (comparatif de supériorité).
plu. plus (durée), de plus, davantage.
poent| point (au jeu).
pokal| coupe, gobelet.
polur| poli (subst. masc.), lustre.
pork| porc, cochon.
porter| porter (bière).
post. après, derrière.
posten| poste (subst. masc.).
postul| exiger, réclamer.
pram| bac.
premi| prix (récompense), prime.
prez| prix (coût).
prov| essayer, éprouver.
prudent| raisonnable, sensé.
prunel| prunelle (bot.).
prunt| en prêt, prêter, emprunter.
pudr| poudre (pour la toilette).
pulvor| poudre (matière pulvérisée).
putr| pourrir (intr.).


R

rapir| rapière, fleuret.
rast| râteler, ratisser.
redakci| rédaction (ensemble des rédacteurs, service).
registr| enregistrer.
regol|roitelet (zool.).

  mal|rekt| indirect, détourné.
rif| récif, écueil.
rip| côte (anat.).
risk| risquer, oser.
rost| (faire) rôtir (trans.).
rul| (faire) rouler (trans.).


S, Ŝ

ŝaf| mouton.
sagac| subtil, ingénieux, perspicace.
sakr| sacrum (anat.).
ŝalm| chalumeau (mus.).
ŝancel| faire chanceler, ébranler.
ŝarĝ| charger (d'un fardeau)
ŝat| estimer, apprécier.

  mal|ŝat| dédaigner, faire peu de cas de.
satur| saturer (chim.).
ŝaŭm| écume, mousse.
se. si (conditionnel).
seĝ| siège, chaise.
senc| sens, acception, signification.
servic| service (de table).
servut| corvée, servage.
sibl| siffler (vent, etc.), bruire.
silur| silure (zool.).
ŝir| déchirer, arracher.
siring| lilas, seringa.
skabi| gale.
skal| échelle (mesure, série).
skerm| faire de l'escrime, se battre (à l'arme blanche).
skurĝ| fouet, martinet, knout, verges.
ŝmac| baiser bruyamment.

  mal|sobr| intempérant.
solv| résoudre, dissoudre,
sonĝ| songe, rêve.
sonor| tinter, sonner, résonner.
sopran| soprano.
sorb| humer, absorber, s'imprégner de.

  en|spez| encaisser.
spin| épine dorsale, échine.
sput| cracher, expectorer.
stabl| tréteau, chevalet, établi.
stal| écurie, étable.
steb| piquer (couture).
step| lande, steppe.
ŝtof| matière, étoffe.
sublimat| sublimé (chimie).
suk| jus, suc, sève.
sulk| sillon, ride.
surtut| redingote, jaquette, etc.
sving| brandir, agiter.
ŝvit| suer, transpirer.


T

tabl| table (meuble).
taĉment| détachement (milit.).
tapet| tapisserie, tenture, papier peint.
ted| provoquer la satiété, importuner, obséder,
tem| thème, sujet, donnée, matière à traiter.

  kun|tir| contracter, resserrer.
torf|tourbe.
tornistr| havresac, sac d'école.
traf| toucher le but, atteindre.
trajt| trait (du visage, du caractère, etc.).
trakt| traiter, négocier.
tref| trèfle (cartes).
tremol| tremble (bot.).
tril| trille (mus.).
trud| imposer, contraindre.
tuk| mouchoir, (un) linge.
turment| tourmenter, torturer.
turn| tourner (trans.).


U

uln| aune (mesure de longueur).
unc| once (mesure de pesanteur).
ur| aurochs, ure.
uter| utérus.
uz| employer, se servir de, user de.


V

vafl| gaufre (pâtisserie).
vag| vaguer, errer, rôder, vagabonder.
van| vain, inutile.
vart| soigner, garder (un enfant).
vaz| vase (ustensile).
veget| pousser, végéter.
vekt| fléau de balance.
venĝ| se venger de, venger.
verŝ| verser (un liquide).
viburn| viorne, obier (boule de neige).
vidv| veuf (subst.).
vind| emmailloter, enrouler (autour de).
vual| voile (subst. masc.).



Z

zizel| marmotte de Sibérie.

 

 
 

ANGLA PARTO (16) (17)

(Ĉefaj kunlaborantoj: F-ino Adela SHAFER, S-roj RHODES,
MILLIDGE kaj ELLIS.) (18).

Kiam la senco de iu vorto ne estas la sama, se (19) tiu ĉi vorto
estas verbo aŭ substantivo, oni aldonis la verbigan prepozicion /to/,
aŭ la literojn: /vb/, post la vorto. Ekz.: arm = to arm. La vorto arm
signifus: brako, kun /to/ oni tuj komprenas, ke ĝi signifas armi.

Kiam la traduko bezonas aldonan vorton por klarigi la unuan,
oni aldonis ĝin. Ekz.: la vorto order signifas ĉu ordeno, ĉu ordo, ĉu
mendo, ĉu mendado, k.t.p. Order bezonas do klarigan vorton.

Kiam la signifo estas duba, ĉar ekzistas en la angla lingvo du
apartaj signifoj, kiuj povas aŭ ne esti ĝustaj, oni metis ĉiam la du
signifojn. Ekz.: gri' = 1) hulled grain; 2) coarse oatmeal.

(16) Th. CART (1922). — Ni ĉi tie danku S-ron M. C. BUTLER kiu
bonvole kontrolis la lastan presprovaĵon.

(17) Komparu: Prepardokumentoj: OG 4, 10 (43), 25 APR 12, p. 363-
375 kaj OG (44), p. 400-411. Modifojn vidu en OG (64), p. 200.

(18) La angla komisiono elektita de la L.K. en 1906 konsistis el F-ino
SHAFER kaj S-roj RHODES kaj ELLIS (Vd. noton 15).

(19) Tiu /se/ estas anglismo signifanta: laŭ tio, ĉu.



A

absint| absinth.

  sub|aĉet| suborn, bribe.
acid| acid, sour.
adiaŭ. adieu, good-bye.
adult| commit adultery.
afekt| be affected, mince.
agac| setting on edge (teeth, etc.).
agord| tune (vb.).
ajl| garlic.
akar| mite (insect).
akcent| accent. (tonic).
akuŝ| be confined (in childbed) (intr.).
alte| marshmallow.
ampleks| extent, size.
ananas| pine-apple.
aniz| anise (arom. plant).
anonc| announce, advertise
antikv| ancient, antique.
apart| separate, special.
apog| lean upon, support (trans.).
arĉ| bow (Violin, etc.).
ardez| slate (substance).
aren| arena.
arm| to arm.
atene| make an attempt against, assault.
atest| attest, testify (certify).
atripl| orach (bot.).
atut| a trump (cards).
aŭtun| autumn, fall.
avid| greedy, eager.
aviz| a notice, notification.
azot|nitrogen, azote.


B 

bala| sweep (vb.),
bant| knot (of ribbon, etc.)
  bapt|an| sponsor, gossip, God-relation.
  bapt|o|patr| Godfather.
  bar|il| barrier.
barakt| throw oneself about, struggle.
barĉ| beetroot soup.
bark| bark (ship).
bask| basque (of bodice, coat, etc.).
bast| bast, inner bark (tree).
bazar| bazar.
bedaŭr| regret, be sorry.
beladon| belladonna, deadly nightshade.
best| animal, beast.
blat| blackbeetle, cockroach.
blond| blond, fair.
blov| blow (trans.).
boa| boa (serpent).
bombon| a sweet, bonbon.
border| border, hem.
bret| shelf, rack.
briliant| brilliant, gem.
brod| embroider.
brut| head of cattle.
bub| lad, urchin.
bubal| buffalo.
buk| buckle, clasp.
bukl| curl, ringlet.
bul| lump, clod, ball.
bulb| bulb, onion.
bulk| manchet loaf, roll (bread).
burd| bumble-bee, ble-bee.
buŝum| muzzle.
butik| small shop.


C, Ĉ

ĉagren| vex, annoy.
ĉambr| room, chamber.
ĉan| cock (of a gun).
ĉap| cap, bonnet.
ĉar. for, since, because.
ĉarnir| hinge.
ĉef| chief (adj.), head.
ĉerp| draw (water, etc.).
ĉia. every, every kind of.
ĉiel| sky, heaven.
  ĉiel|ark| rainbow.
ĉif| crumple, tumble.
cifer| a cipher, numerical figure.
ĉikan| cavil at, gossip mischievously.
cirkel| compasses (geom.).
cit| cite, quote, name.
citr| cithern, zithern.
civiliz| civilize.
ĉiz| carve, chisel.


D

datur| thorn-apple, datura.
daŭr| last (intr.).
dec| be fitting, proper.
deĵor| be on duty, on service.
deklinaci| decline (gram.).
delir| be delirious, rave.
demand| ask (a question).
denar| denarius (coin).
desegn| design, draw.
detal| detailed, in detail.
dezert| a desert.
diboĉ| live in debauchery.
dig| embankment, dike.
dik| thick, corpulent.
direkt| direct, steer.
dis| denotes separation e.g. sem sow - dissem disseminate.
distil| distil.
divid| divide, share.
dolor| pain (vb.), hurt.
dorlot| spoil (vb.), pet (child).
dors| back (body).
drak| dragon.
drap| woollen cloth.
drapir| drape, hang (trans.).
draŝ| thrash (corn).
dres| train (soldier), tame (animal, etc.).
drink| drink to excess, tipple.
drog| a drug.
dron| be drowning.
dum. while, whilst.
  dum|e. meanwhile.
dung| hire, engage.

 
E

eben| even, level.
efik| be effectual, work (intr.).
ekscelenc| Excellency (title).
eksped| dispatch, forward.
ekspozici| exhibition.
ekstr| extra.
ekzamen| examine, test.
ekzekut| execute, put to death.
ekzempler| copy (of a book, etc.)
ekzerc| practise, exercise (vb.).
elast| elastic.
embaras| embarrassment, perplexity.
enu| be bored, weary.
erp| harrow (vb.).
esplor| investigate, explore
etaĝ| story (of a house).
etat| statement (finance etc.).


F

fabrik| make, manufacture.
faden| thread (a).
  metal|faden| wire.
fajenc| earthenware, crockery. 
fajf| whistle (vb.).
fajl| file (vb.).
fak| department, compartment.
faktur| invoice.
falbal| flounce, furbelow.
fald| fold, pleat (vb.).
fam| rumour, report, fame.
fand| melt, smelt (vb.).
fantom| phantom, spectre.
far| do, make.
faring| pharynx.
farm| take on lease.
farun| meal, flour.
fason| fashion, make, cut (of clothes, etc.).
fav| kind of ringworm.
feĉ| lees, dregs.
felt| felt (cloth).
ferdek| deck (of ship).
fest| celebrate.
fin| finish, end (trans.).
  firm|o. firm (a).
fleg| nurse, tend.
flor| bloom, flower (vb.).
foli| leaf, sheet (paper).
font| spring, source.
fontan| fountain.
for. forth, away.
forĝ| forge (smith's work).
forn| stove, furnace, oven.
  for|permes| grant leave of absence, give furlough.
fortepian| pianoforte.
fortik| strong, durable, robust.
frakas| shatter, smash.
fraksen| ash (tree).
frand| revel in dainties, junket.
frangol| black alder, buckthorn.
frap| hit, knock (vb.).
frenez| mad, crazy.
fring| chaffinch.
friz| friz, curl, dress (hair).
funebr| mourning.
funebra. funereal.
fung| fungus, mushroorm.
fuŝ| bungle, blunder, botch.
fut| foot (measure).


G, Ĝ

gad| hake, stockfish
galanteri| haberdashery, trimmings.
galon| galloon (gold or silver lace).
galoŝ| galosh.
gam| musical scale, gamut
garanti| guarantee (vb.).
gard| guard, watch over.
gargar| gargle, rinse.
ĝen| inconvenience, bother, disturb.
ĝentil|polite, courteous.
ĝerm| germ.
ĝiraf| giraffe.
glaci| ice (natural).
glad| to iron.
glas| a glass, tumbler.
glat| smooth, glossy (not rough).
glim| mica.
glit| glide, skate, slide.
  glit|vetur|il| sledge.
glor| glorify.
ĝoj| rejoice, be glad.
golf| gulf.
  gren|ej| granary. hulled grain (t.e. senŝeligita greno ia);
gri| coarse oatmeal (t.e. aveno duone muelita).
grifel|slate-pencil.
grinc| gnash, grind (of teeth, etc.).
groŝ| groschen (coin).
grot| grotto.
ĝu| enjoy.
gum| gum (product).
gurd| streetorgan, hurdy-gurdy.
  gust|um| taste (trans.).
ĝust| right, exact, correct.
guvern| teach privately (act as tutor).
gvardi| guard (subst.) (milit.).


H

hal| hall (market, etc.).
haladz| fume, exhalation.
  har|lig| plait, tress of hair.
haŭt| skin (subst.).
hel| light, clear.
herni| hernia, rupture (med.).
hero| hero.
ho! oh!
hom| man (the species).
honor| honour (vb.).
hont| be ashamed.
hortulan| ortolan (bird).
hosti| host (consecrated wafer).
humor| temper, humour.


I

ia. of some kind, any.
ial. for some cause.
iam. at some time, ever.
ie. somewhere.
iel. somehow.
ies. someone's.
ilumin| illuminate (lamps, lights, etc.).
ind| worthy of.
indign| be indignant.
indulg| be indulgent, be merciful, spare
iniciat| initiate, start.
inklin| inclined, disposed.
inokul| inoculate.
insign| insignia, armorial bearings.
insult| abuse, revile.
io. something.
iom. a little, some quantity.
iu. someone.


J, Ĵ

ja. emphatic particle.
juĝ| judge (vb.).
ĵus. just (adv. of time).


K

kadr| frame (a).
kaduk| decrepit, decayed (of things).
kahel| earthen (etc.) tile, flagstone (building).
kajer| unbound book, part (of same).
kalik| chalice, cup.
kambi| bill of exchange.
kamer| room (dark), camera.
kamfor| camphor.
kamlot| camlet (cloth).
kan| cane (reed).
kanajl| scoundrel, rascal.
kantor| chanter, precentor.
kanvas| canvass (material).
kapitel| capital (of pillar).
kapor| caper (berry).
kapot| greatcoat (with cape).
kapuĉ| cowl, hood.
karas| crucian (fish).
karnaval| carnival.
karo| diamonds (cards).
karob| carrob-bean, locust (fruit).
kartav| trill the r strongly.
kartoĉ| cartridge (for gun).
karton| cardboard.
karusel| roundabout.
kas| till, cash-box, chest (money).
kaserol| stewpan, saucepan.
kastr| castrate.
katarakt| cataract (eye).
kav| cavity, hollow.
kaz| case (gram.).
kaze| curds.
kegl| skittle.
kelk| some, a few, certain.
kelner| waiter.
ker| hearts (cards).
kern| kernel, pip.
kil| keel.
kitel| smock, blouse.
klav| key (of piano, etc).
kler| well-educated, cultured.
kloŝ| bell-shaped cover (clock-shade, etc.).
klub| club, association.
kluz| sluice, lock.
kok| cock (bird).
kokcinel| ladybird.
koket| coquet (adj.).
kokluŝ| whooping-cough.
kokos| cocoa-nut.
koks| hip, haunch.
kolbas| sausage.
koler| be angry.
kolibr| humming-bird.
kolimb| diver (bird).
kolor| colour, hue.
kolport| hawk (sell), peddle.
komand| command (mil. and nav.).
komb| comb (vb.).
komisi| commission, entrust.
komplez| favour, kindness.
kompres| compress (bandage).
komun| common (to all).
kon| know, recognize, be acquainted with.
kondolenc| condole (with).
konduk| conduct (vb.), steer.
kondut| behave, conduct (oneself) (intr.).
konjekt| conjecture, guess.
konk| shell, conch.
konkur| rival, compete.
konkurs| a competition.
konsonant| consonant (gram.).
konstern| dismay, disconcert, startle.
kontraŭ| against, opposite.
konval| lily of the valley.
konven| be suitable, suit.
konvert| convert (vb.).
kord| string (mus. instr.).
kork| a cork.
kornic| cornice.
kort| court, courtyard.
    kort|eg|court (of a king).
kost| cost (vb.).
koton| cotton (product).
kov| brood, sit (as a hen etc.).
  
  kovr|il| a cover.
  mal|kovr| uncover, lay bare.
krad| grating, cross-bars.
krak| crack, noise.
kramp| clamp, bracket.
kran| tap, cock.

  kred|ebl| probable.
  kresk|aĵ| plant, growth.
krev| burst (intr.).
kri| cry out, cry.
kribr| sieve, sift.
kriminal| criminal (adj.).
kring| ring-shaped cake.
kripl| deformed, cripple (adj.).
krisp| mesentery, ruffle (a).
kritik| criticise.
krom. not counting, besides, except.
kroz| cruise (of warships).
kruĉ| jug, pitcher, cruise
krur| leg.
kuf| coif, cap, head-dress
kuir| cook (vb.).
kuk| cake, cookey.
kukurb| pumpkin, gourd.
kulp| guilty, at fault.

  flav|a kupr|o. brass.
kur| run (intr.).
kurac| treat (as an illness), cure.
  kurac|il| medicine, remedy.
kuraĝ| courageous.
kurator| trustee, curator.
kurb| curved, bent.

  flank|kurten| curtain (side).
  rul|kurten| window-blind.
  kusen|eg| bolster (of bed).
kutim| be accustomed.
kuv| tub, bath.
kvartal| quarter (of town), ward.
kvit| be quit of.
kvitanc| receipt (vb), give a quittance.


 
L

labor| work, labour.
  per|labor| earn one's living.
laĉ| lace (boots, stays, etc.).
lad| tinned iron.
laks| diarrhoea, looseness (of bowels).
lakt| milk (subst.).
  lakt|um| spawn, milt.
lang|tongue (organ of speech).
lanug| down, fluff (of feathers).
lard| bacon.
larm| tear (subst.) (shed a).
laŭb| arbour, summer-house.
laŭr| laurel (tree).
legom| vegetable (eatable).
lekant| marguerite.
lesiv| lye, buck (for bleaching).
levkoj| wall-flower, gilly flower.
lian| liana (bot.).
  libr|o|ten|ant| book-keeper.
liken| lichen (bot.).
likvor| liqueur (a cordial).

  lim|ig| limit (vb.).
lini| line.
lit| bed (couch).
liter| letter (of alphabet).
loĝ| dwell, lodge, live.
loĝi| lodge, box (theatre).
lol| tare (plant).
lu| hire, take on rent.
luks| luxury.
lum| shine, give light.


M

magazen|shop, store, ware-house.
majest| majestic, dignified.
majstr| master (of his art).
  sub|majstr| journeyman, fore-man.
makler| act as broker, deal.
mam| breast, udder.

  man|plat| palm (hand).
  man|um| cuff (of sleeve), wristhand.
mank| want, lack.
manovr| manœuvre (milit. and nav.).
marĉand| bargain (vb.).
marcipan| marzipan (almond paste).
markot| layer (hort.).
maroken| morocco leather.
mastik| mastic, putty.
mastr| master (of house), host.
matur| mature, ripe.

  meĉ|aĵ| tinder, match.
membr| member, limb.
memor| remember.
mend| bespeak, give an order.

  el|met| display, expose.
  al|mezur| try on, fit on, adjust.
milit| make war.
minac| menace, threaten.
miop| short-sighted.
mod| fashion, mood (gram.).
mok| mock, ridicule.
montr| show (vb.).
mor| custom, usage.
muel| grind, mill.
muĝ| roar (wind, etc.).
muk| mucus.
mustel| weasel, marten.



N

nap| cabbage-turnip.

  neces|ej| water-closet.
  neces|uj| workbox-sewing-case.

negliĝ| négligé, loose-gown.
nenia. not any kind of, no.
neniel. in no way, not anyhow, not at all.
nepr|e. without fail.
net| clean (as a copy), neat. 
  mal|net| rough draft.
nivel| level (sea, etc.).
not| make a note of, note.
nuanc| nuance, shade, hue.
nud| nude, naked, bare.
nuk| nape (of neck).
nul| zero, nought.
nutr| nourish, feed (trans.).


O

oblat| wafer, seal.
odor| give out odour, smell.
ofer| sacrifice, offer.
ofic| office, duty, function.
  ofic|ist| official, functionary.
  ofic|ej| bureau, office.
oficir| officer (mil. and nav., etc.),
oksikok| cranberry.
okzal| sorrel (plant).
opini| be of opinion, think.
orden| order (of knighthood etc.).
orgen| organ (mus.).
orient| east, orient.
ornam| ornament (vb.), adorn.
osced| yawn, gape.


P

paĝ| page (book).
paĝi| page (servant).
pak| pack, put up.
palm| palm-tree.
  
  palpebr|um| blink, wink.

pantalon| trousers.
pantofl| slipper.
parad| parade, make a show.
parfum| perfume, scent.
parget| parquetry.
parker| by heart.
  
  inter|parol| conversation.
  parto|pren| take part in, participate.

parter| pit (theatre), ground-floor.
parti| party, faction.
paru| tomtit, titmouse.
pas| pass (intr.).
paŝ| step, pace.
pasament| braid-trimmings, passementerie.
  pasament|ist| maker of trimmings
pasi| passion (not anger).
pasport| passport.
past| dough, paste.
paŝt| feed (animals), graze, pasture (trans.).
pasteĉ| tart, pie, pasty.
pastel| lozenge.
pav| peacock.
peg| woodpecker.
pekl| pickle in brine, salt (vb.).
pel| drive, chase (vb.).
pen| endeavour, try to.
pend| hang (intr.).
  de|pend| depend, hang from.
  el|pend|aĵ| signboard.
pendol| pendulum.
pentr| paint (vb.).
pep| chirp, warble.
perĉ| pope, ruffe (fish) (acerina vulg.).

  pere|ig| cause to perish, wreck.
perk| perch (fish).
  
  for|permes| grant leave of absence, give furlough.
peron| door-stop, platform (in a station, etc.).
persekut| persecute, prosecute.
petol| be mischievous, romp, wanton.
petrol| petroleum.

  pez|il| weight (for scales).
pice| silver fir-tree.
pied| foot (body).
pik| prick, sting; spade (cards).
  pik|il| sting (a).
piked| picket (milit.), piquet (cards).
pini| Siberian cedar.
pips| pip (poultry disease).
piroz| pirosis (med).
pist| pound, bray (in a mortar)
plaĉ| be pleasing, please (intr.).
plad| dish, platter
plastr| plaster (med.).
plaŭd| splash, ripple, purl.
plen| full, complete.
  plen|um| fulfil, accomplish.
plet| tray, salver.
plik| Polish ringworm.
plot| roach (fish.).
plug| plough (vb.).
plum| feather, pen.
po. at the rate of.
poent| point (in games).
polic| police (the system).
polur| polish, gloss.
polus| pole (geol.).
polv| dust (subst.).

  ter|pom| potato.
porcelan| china, porcelain.
pork| pig.
port| carry.
  el|port| bear, endure,
porter| porter, beer.
poŝt| post (the system).
posten| post (milit.).
pra. great-, fore- (rel. to ancestors and descendants).
praktik| practice (of a profession).
pram| ferry-boat, praam.
predikat| predicate (gram.).
premi| prize, reward (subst.).

  pren|o. trick (cards).
pretend| lay claim to.
preter. beyond, past, by.
prezent| present (vb.), introduce (a person).
printemp| springtime.
procent| percentage, interest (money).
prokrast| delay, defer.
promen| to walk, promenade.
prosper| to succeed in.
prov| attempt, try to.
prudent| reasonable.
prunt| borrow, loan.
pudr| powder (cosmetic).
pulvor| powder (med. or chem.).
pump| pump (vb.).
punĉ| punch (drink).
punkt| full stop, dot, point.
punt| lace (point, etc.).
pupil| pupil (eye).
pur| clean, pure.
putor| pole-cat, skunk.
putr| rot, putrify.


R

rabot| plane (vb.).
rand| edge, border, hem (s.).
rapir| rapier, foil.
rasp| rasp, grate (vb.).
rast| rake (vb.).
rav| enrapture, delight.
redakci| editorial department.
reg| rule, govern.
region| district, region, part.
regn| State (the).
regul| rule (subst.).

  mal|rekt| crooked, not straight.

rel| a rail.
rembur| quilt (vb.), stuff, pad.
rent| yearly income.
  
  respond|ec| responsibility.
ret| net (a).
rev| dream (vb.).  
  dis|rev|iĝ| disenchantment.
ribel| revolt, rebel (vb.).
rif| reef.
rifuĝ| take refuge, shelter.

  rifuz|iĝ| renounce claim.
rigl| bolt (vb.).
rilat| relate to.
rimen| strap (a).
  
  ring|eg| hoop.
risort| spring (s.) (mech.).
riverenc| curtsey.
rod| landing-place (mar.)
rosmar| walrus.
rostr| trunk (proboscis).
rot| troop, company (soldiers).
ruin| ruins, a ruin.
  ruin|ig| ruin, destroy.
rukt| eructation.
ruz| cunning, sly.


S, Ŝ

  sabl|aĵ| sandbank.
sakr| sacrum (anat.).

  sal|amoniak| sal-ammoniac.
salat| salad.
ŝalm| reed-pipe.
salon| drawing-room.
ŝam| chamois-leather.
sambuk| elder-tree.
ŝancel| stagger, cause to totter (trans.).
sankt| sacred, holy.
sardel| sardine.

sark| weed (vb.).
ŝat| prize, value.
  mal|ŝat| hold of no value, not care about.
satur| saturate.
sav| save, rescue.

  sci|iĝ| be told, hear.
seb| tallow, suet.
seg| saw (vb.).
seĝ| chair.
sekund| second (a).
ŝel| shell, peel, bark.
  sen|ŝel|ig| shell, peel (vb.).
ŝelk| braces, suspenders.
senc| sense, meaning.
sentenc| sentence, judgment.
serur| lock (fastening).
servut| bondage.
sever| severe, strict.
silent| be silent.
silvi| warbler (bird).
ŝim| grow mouldy.
ŝind| shingle (roofing).
ŝink| ham.
ŝirm| protect, screen.
sitel| bucket, pail.
situaci| situation, position.
skabi| mange, scab.
skal| scale (measure).
skapol| shoulder-blade.
skerm| fence (vb.).
skolop| woodcock.
sku| shake (trans.).
ŝmac| kiss loudly (with a smack).
ŝmir| spread, smear.
solv| dissolve.
son| sound (intr.).
sopir| long for, yearn.
sopran| soprano, treble.
sorb| absorb, sip.
sorĉi| practise witchcraft.
sorp| sorb (sorb-apple).
ŝov| thrust, shove.
ŝovel| shovel.
ŝpar| save, be sparing of.
spat| spar (min.).
spert| experienced.
spez| turnover (money), exchange.
  el|spez| expend.
  en|spez| have income, receipt.
spion| spy (a).
sprit| witty, quick-witted.
ŝpruc| spirt, gush (intr.).
sput| spit (blood, phlegm etc.).
stabl| trestle, workman's bench.
staci| station, dept (rail-road).
  staci|dom| station (building).
stal| stall, shed, stable.
stamp| stamp (with a die).
steb| stitch (back) (vb.).
step| steppe, moor.
stern| spread out (on ground, etc.), lay.
stertor| to rattle (in the throat).
stip| feather-grass (stipa)
ŝtof| stuff.
ŝtop| stop up, bung up.
streĉ| stretch, strain.
strek| make a line or stroke.
stri| stripe, band.
strik| strike (labour).
student| student (of college etc.).
stuk| stucco (vb.).
ŝtup| tow (subst.).
  ŝtup|ar| staircase, ladder.
subjekt| subject (gram.).
sublimat| corrosive sublimate.
sufok| suffocate (trans.).
sukces| succeed.
ŝultr| shoulder.

  re|sum| make a summary.
  sun|flor| sunflower
  super|jar| leap-year.
supr|o. summit, top.
surtut| overcoat.
ŝut| pour out (solids).
svat| act as matchmaker.
sven| faint, swoon.
sving| swing (trans.).


T

tabul| board, plank, tablet.
taĉment| detachment (troops).
taft| taffeta (material).
tali| figure, waist, stature.

  tambur|i. beat (drum).
tapet| wall-paper, paper-hangings.
tavol| layer, stratum.
ted| bore, weary, annoy.
teg| cover (wholly) (vb.).
  teg|o.  covering, slip.
tem| theme, topic.

  ten|il| handle, haft.
  de|ten| abstain from, restrain.
tend| tent.
tent| tempt.
termin| term, technical name.
terur| terror, horror, fright.
testament| will, testament.
tez| thesis, proposition.


timon| haft, pole.
tio. that (thing).

  kun|tir| draw together.
tiu. that (one) (person or thing).
tol| linen (mat.).
  tol|aĵ| underlinen (washing).
tomb| tomb, grave.
torf| peat, turf.
tra. through (place).
traf| hit the mark.
trajt| lineament, feature.
trakt| transact, treat of (a subject).
trankvil| tranquil, quiet.
tref| clubs (at cards).
tremol| aspen.

  tri|foli| clover, trefoil.
trikot| stockinet (mat. for tights, jerseys, etc.).
trip| tripe.
trotuar| pavement.
  
  tro|uz| use to excess, abuse.
tuber| tuber, bump, swelling.
tuj. immediately.
tuk| a cloth.
turn| turn (trans.).
turnir| tournament.
tut| whole, entire, total
uln| ell (cloth measure).


U

  ung|eg| claw, talon.
uniform| uniform (dress).
uter| matrix (anat.), uterus.
util| useful.
  mal|util| harmful.

uz| use, employ (vb.).
  uz|aĵ| implement, utensil.
  tro|uz| use to excess, abuse.


V

vafl| wafer (cake).
vag| rove, wander about.
vagon| carriage (railway).
vakcini| vaccinium (vitis idaea).
van| futile, vain.
vang| cheek.
vanil| vanilla (spice).
vant| frivolous, vain, empty.
vapor| vapour, steam.
varb| enlist, enrol.
vart| nurse, tend (children).

  mal|vast| narrow, restricted.
  vast|ig| extend, enlarge (trans.).
vat| wadding.
vaz| vessel, vase.
vek| wake, arouse (trans.).
vekt| beam (of scales, balances, etc.).

  de|ven| be derived from, originate from.
venĝ| take revenge, avenge.
vent| wind (subst.).
ver| truth.
vert| top (of head), pate.
vertebr| vertebra.
vestibl| lobby, vestibule.
veŝt| waistcoat.
viburn| guelder-rose, viburnum.
vigl| alert, spirited.
vikari| vicar, deputy.
  
  vilaĝ|an| villager, peasant.
vin| wine.
vind| swaddle, swathe.
viol| violet (flower).
vir| man, male.
volv| wind, wrap round (trans.).
vulkan| volcano.
vultur| vulture.


Z

zizel| zizel (zool.).
zon| belt, girdle.
zorg| look after, see to.
  zorg|ant| guardian.
  zorg|at| ward.

 

GERMANA PARTO (20) (21)

(Ĉefaj kunlaborintoj: S-roj ELB, CHRISTALLER kaj F-ino
SCHEFER) (22)

(20) Th. CART (1923). — Ni ĉi tie danku S-ron Dipl. Inĝ. R. HAFERKORN,
kiu bonvole kontrolis la lastan presprovaĵon.
(21) Komparu: Prepardokumentoj: OG 5, 2 (46), 25 JUL 12, p. 64-73.
Modifoj en: OG (64), p. 201.

(22) La germana komisiono elektita de la L.K en 1906 konsistis el S-roj
CHRISTALLER, HANAUER, MYBS (Vd. noton 15).


A

absces| Eitergeschwür.
adverb| Umstandswort.
afekt| sich zieren.
agac| Stumpfheit der Zähne.
ajn (kiu...). auch nur, auch immer (wer...)
amoniak| Ammoniak.
ampleks| Grösse, Umfang.
angul| Winkel, Ecke.
anonce| anzeigen, ankündigen.
aplaŭd| Beifall spenden.
apog| anlehnen, stützen.
apud. neben, an, bei.
arĉ| Fiedelbogen.
argument| argumentieren, beweisen, Schlüsse ziehen.
artifik| List, Kniff.
asekur| versichern.
atripl| Gänsefuss (Pflanze).
aviz| Ankündigung, Anzeige.


B

bant| Bandschleife.
barĉ| Runkelrübensuppe.
  batal|il| Waffe, Wehr.
bazar| Markt, Basar.
bel| schön.
bombon| Bonbon, Zuckerwerk.
border| säumen, einfassen.
bov| Ochs, Rind.
branĉ| Ast, Zweig.
brasik| Krautkopf, Kohl.
brik| Backstein, Ziegelstein.
briliant| Brillant (Stein), geschliffener Diamant.


C, Ĉ

ĉe. bei, zu.
cert|a. sicher, gewiss.
ĉikan| schikanieren,
ĉiu. jeder, jedermann.
civiliz| zivilisieren, aufklären.
ĉiz| meisseln, ziselieren.


D

da. (forigu: ersetzt den Genitiv).
de. von, von...an, seit; kennzeichnet auch den Genitiv.
dec| (sich)  gebühren, sich schicken.
delir| irre reden, wahnsinnig sein.
dev| müssen, sollen.
deviz| Wahlspruch, Devise.
diboĉ| ausschweifen, schwelgen.
didelf| Opossum, Beuteltier.
direkt| richten, leiten.
do. doch, also, denn.
dolĉ| süss, sanft, mild.
dorlot| verziehen, (ver)hätscheln.
dung| mieten, dingen.


E 

eksped| befördern, versenden.
eksplod| zerspringen, explodieren, ausbrechen.
em| -haft, geneigt (babilem- = schwatzhaft).
er| ein einzelnes von...
estim| achten, schätzen.
estr| Vorsteher, z. B. ŝip- = Schiff, ŝipestr. = Kapitän.
fajenc| Fayence, Halbporzellan.
faktur| Rechnung, Faktura.
fart| sich (gesundheitlich) befinden.
  fart|o. Befinden, Zustand.
fask| Bündel.
fav| (Kopf)grind.
feĉ| Hefe, Sediment.
femur| (Ober)schenkel, Keule.
fid| vertrauen, sich verlassen.
figur| darstellen, abbilden.
flan| Fladen, Plinse.
fleg| pflegen, verpflegen, warten (z.B. Kranke).
flik| flicken,
fokus| Brennpunkt.
for. fort, weg.
fraŭl| Junggeselle.
furaĝ| Futter, Verpflegung
furunk| Hautgeschwŭr, Blutgeschwŭr.



 
G, Ĝ
 

galon| Gold-, Silberborte, usw.
gam| Tonleiter.
ĝentil| höflich, artig.
glut| verschlingen, verschlucken; einnehmen (Medizin).
golf| Golf, Meerbusen.
graci| graziös, zierlich.
grifel| Griffel, Stichel.
gvid| führen, leiten.


H

ha. ha! ach!
  
  har|ar| Behaarung.
ho. o! ach! oh!


I

idol| Abgott, Götze.
ig| brul- = brennen (intr.); brul-ig- = brennen (tr.).
iĝ| in einen Zustand gelangen.
iĥtiokol| Fischleim.
imag| sich einbilden.
indulg| nachsichtig sein, schonen.
ifuz| ziehen lassen, aufgiessen (Tee).
inklin| geneigt, bereit zu.
insign| Wappen, Wahrzeichen, Abzeichen.
insult| (be)schimpfen.
inter. zwischen, unter.
interjekci| Ausrufswort.
interpunkci| Zeichensetzung.
intim| vertraut, intim.
intrig| intrigieren, Ränke schmieden.
intermit| aussetzen (technisch).
ist |bezeichnet den Träger des Berufs, der regelmässigen Beschäftigung mit etwas.

J, Ĵ

ĵus. soeben, gerade, just.


K

kan |Schilf, Rohr.
kapr| Ziege.
kapuĉ| Kapuze.
karnaval| Karneval, Fasching.
kataplasm| Umschlag, Pflaster.
kaz| Kasus, Fall.
ke. dass.
kiam. als, wann, wenn.
klav| Taste.
klopod| sich anstrengen, sich bemühen.
kokos| Kokosnuss.
koleg| Kollege.
kolubr| Natter (giftlose ~)
komunik| verbinden, anschliessen; mitteilen.
konform| entsprechend, ŭbereinstimmend.
konstat| feststellen, konstatieren.
konsum| verzehren, verbrauchen.
konven|sich passen, sich geziemen.
konvulsi| Zuckung.
kopi| abschreiben, kopieren.
korekt| berichtigen, verbessern.
korespond| Briefe wechseln, korrespondieren.

  kort|eg| Hof (eines Fürsten).

kostum| Kostüm, Tracht.
kovr| bedecken, verhüillen.
  kovr|il| Umschlag. Hülle, Decke, Deckel.

krak| krachen, knacken.
kran| Zapfen, Hahn.

  kred|ebl| glaublich, warscheinlich.

krev| platzen, bersten.
kripl| verstümmelt, verkrüppelt.
krur| Bein, Unterschenkel.
krust| Kruste, Rinde.
kurac| (ärztlich) behandeln.
kuraĝ| mutig, kühn.
kurb| krumm, gebogen.

  kusen|eg| Pfühl, Plumeau.
kutim| gewohnt sein, pflegen
kuv| Wanne, Kübel.
kvartal| Stadtviertel.
kviet| sanft, ruhig.


L

  laŭ|larĝ|e. der Breite nach, quer.
laŭt| laut.
lekant| (weisse)Gänseblume.
leontod| Löwenzahn (Pflanze).
lert| geschickt, gewandt.
lev| heben.
lini| Linie, Zeile.
lunatik| mondsüchtig.
makler| Makler sein, Geschäfte vermitteln.
malgraŭ| ungeachtet, trotz.
memor| sich erinnern, gedenken.
met| hintun, setzen, stellen, legen.

  mez|o|nombr| Durchschnittzahl.
  al|mezur| anmessen.
miogal| Bisamratte.
model| Modell, Muster.
muĝ| brausen, brüllen.
murmur| murmeln, brummen.
muslin| Musselin, Nesseltuch.

  nask|iĝ| geboren werden, entstehen.
nenia. keinerlei.
nenies. keines, niemandes.
neniu. kein, niemand.
nest| Nest.
net| Reinschrift.
  mal|net| Konzept, Entwurf, Kladde.
nobl| edel, vornehm (Gesinnung).
nuk| Nacken, Genick.



O

obl| bezeichnet das Vervielfältigungswort.
  du|obl| zweifach, doppelt.
okaz|o. Fall, Ereignis, Gelegenheit.
okzal| Sauerampfer.
oportun| bequem, gelegen.
ornam| schmücken, (ver)zieren, (an)putzen.
  
  de|pago. Abgabe, Zoll.
palp| tasten, fühlen.
parad| prangen, prunken.
paraliz| lähmen.
paroĥ| Kirchspiel, Pfarre.
pas| vorbeigehen, vergehen.
paŝt| weiden (tr.).
penik| Pinsel.
pensi| Ruhegehalt, Pension.
peritone| Bauchfell.
perk| Barsch.
pice| Weisstanne.
pied| Fuss.
pingl| (Steck)nadel.
pirit| Kies, Feuerstein.
posed| besitzen.
preciz| genau.
pret| fertig, bereit.
pretend| beanspruchen.
pri. von, über, betreffs.
profesi| Beruf, Gewerbe.
prosper| glücken, gedeihen.
prunel| Schlehenpflaume.

  punkt|o|kom| Strichpunkt.
  du|punkt| Doppelpunkt.
 

rajt|ig| berechtigen, bevollmächtigen.
rap| weisse Rübe.
registr| eintragen, registrieren.
regn| Staat, Reich.
rekt| gerade, direkt
  mal|rekt| nicht gerade; indirekt.
ribel| sich empören.
ricev| erhalten, bekommen.
rifuz| verweigern, sich weigern, ausschlagen.
rigard| schauen, blicken, betrachten.
riverenc| Verbeugung, Knicks

  rul|o. Rolle,Walze.


S, Ŝ

saĝ| klug, weise.
sagac| scharfsinnig, spitzfindig.
ŝak| Schach (Spiel).
salajr| Gehalt, Lohn.
salik| Weide (Baum).
salvi| Salbei.
sam| selbe(r), gleiche(r).
ŝat| schätzen, Wertlegen auf.

  mal|ŝat| geringschätzen, vernachlässigen.
sent| fühlen, empfinden
sepi| Tintenfisch.
singult| den Schlucken haben.
ŝirm| beschirmen, schützen.
sirop| Sirup.
skadr| Schwadron.
skapol| Schulterblatt.
skiz| entwerfen, skizzieren.
sklav| Sklave.
skurĝ| Knute.

  mal|sobr| ausschweifend, unmässig.
solv| lösen, auflösen.
son| tönen, klingen.
sonor| läuten, hallen.
sopir| sich sehnen, seufzen
sopran| Sopran (weibliche) Oberstimme.
sorb| schlürfen, einsaugen
  el|spez| ausgeben.
  en|spez| einnehmen, lösen.

spit| trotz (dem, der usw).
sput| spucken, speien.
stabl| Staffelei, Gestell.
stal| Stall, Schuppen.
stamp| stempeln, prägen.
standard| Fahne, Banner.
stern| ausbreiten, betten, lagern.
sukces| Erfolg haben, gelingen.

  re|sum| zusammenfassen.
supoz| vermuten, voraussehen.
surtut| Überrock.
suspekt| Verdacht hegen, argwöhnen.



T 

ted| listig sein, Überdruss erregen.

  sub|ten| unterstützen, halten.

tent| in Versuchung führen.
termin| Terminus, Fachausdruck.
tern| niesen.
testik| Hode.
tetr| Birkhuhn.
tetra| Waldhuhn.

  kun|tir| zusammenziehen.
toler| dulden, tolerieren.
trakt| verhandeln.
tremp| tunken, eintauchen.
trivial| trivial, abgedroschen.
tromb| Wasserhose.
tromp| täuschen, betrügen.
trunk| Stamm, Rumpf.
tub| Rohr, Röhre.
tuj. sogleich, sofort.
turment| quälen, peinigen.
tuŝ| berühren.


V

vant| eitel, nichtig, leichtfertig.
venĝ| (sich) rächen.
vest| ankleiden, anziehen.
viburn| Schneeball (Pflanze).

  vin|ber| Weinbeere.
violonĉel| Cello.
vizaĝ| Gesicht, Antlitz.
vizier| Visier (Helm).


 

 
RUSA PARTO (23)

(Redaktita de S. OBRUĈEV) (24)

Antaŭparolo.

La ĉi-sube presitaj korektoj de dubaj tradukoj de Universala
Vortaro estas verkitaj laŭ sekvanta materialo (25):

1. Korektoj, proponitaj de V. DEVJATNIN - 93 vortoj (OG 5,
7 (51), 25 JAN 18, p. 226/231).

2. Kritiko pri 29 vortoj de tiu korektaro, sendita al la 
Akademio de S. OBRUĈEV.

3. Kritiko pri ses vortoj de sama korektaro, senditaj al la
«Ondo de Esperanto» de D-ro V. LEBEDEV.

4. Korektaro de 53 vortoj (ne entenataj en korektaro de 
DEVJATNIN), sendita al la Akademio de V. LEBEDEV.

5. Korektaro de 83 vortoj (ne entenataj en tiu de 
V. DEVJATNIN), sendita al la Akademio de S. OBRUĈEV.


Tiuj manuskriptoj estis zorge komparitaj, kaj la definitivan
korektaron de 208 vortoj ni nun prezentas. La korektoj laŭ sia
karaktero dividiĝas jene:

1. Simplaj ortografiaj korektoj.

2. Anstataŭo de neuzata aŭ neliteratura vorto per moderna.

(23) Th. CART (1923).

(24) La rusa komisiono elektita de la L.K. en 1906 konsistis el 
S-roj AVILOV kaj KOFMAN.

(25) Legu: laŭ la sekvanta materialo.

3. Klarigo de senco per unu aŭ kelkaj sinonimoj — en okazo,
se (26) esperanta vorto havas kelkajn signifojn.

4. Klarigo per sinonimo aŭ preciziga noto (inter krampoj), se
la uzita en U.V. rusa vorto havas du malsamajn signifojn, unu el
kiuj (27) ne egalvaloras al esperanta.

5. Aldono de sinonimo, samradika kaj samsona kun esperanta
vorto — por substreki la internacian karakteron de Esperanto.

6. Korekto de malĝustaj aŭ eĉ eraraj tradukoj.


Por ĉiuj faritaj korektoj la suprecititaj manuskriptoj enhavas
detalan pravigon. La korektoj estis komparitaj kun la vortaroj de
KABE, VERAX, BOIRAC, kelkaj ruslingvaj, kaj la moderna esperanta
uzado. Precipe oni atentis la Esperanto-Rusan vortaron de 
L. ZAMENHOF (eldonoj 1909 kaj 1911 j.), en kiuj la Majstro mem 
enkondukis multajn el proponitaj de ni korektoj.

Moskvo, 10 MAR 23.                  S. OBRUĈEV.


A

abat| аб6ат, игумен, настоятель.
abon| подписываться (на журнал), абонироваться.
ad| означает продолжительность действия или многократный вид.
admir| дивиться, изумляться, босхищаться.
afabl| приветливый, любезный.
afekt| аффектировать, жеманиться, рисоваться.
aĝ| восраст.
akar| клещ.
akompan| сопровождать, акомпанировать.
aplaŭd| хлопать в ладоши, аплодировать.
apr| кабан, вепрь.
apud. возле. подле, около.
arm| вооружать.
arogant| наглый, нахальный.
artrit| подарга.

(26) Legu: en la okazo, kiam.
(27) Legu: el kiuj unu.


B 

bagatel| пустяк, безделица.
baldaŭ. вскоре, скоро.
barbir| цырюльник, парикмахер.
bast| луб, лыко.
batal| бороться, сражаться.
beladon| белладона, сонная одурь.
boat| шлопка, лодка, бот.
bombon| конфета.
border| окаймлять, подшивать (кайму).
brak| рука (от плеча до кисти).
brav| удалой, бравый.
buĉ| закалывать.
bul| ком, комок.
burĝon| почка (растения), бутон.
buŝel| бушель, английская мера сыпучих тел, равная 36,5 литра (прибл. четверик).




ĉagren| причинять досаду, огорчать.
ĉarlatan| шарлатан, мошенник.
ĉarm| милый, очаровательный.



damask| камка (камчатный).
de. от; образует также родительный падеж.
desegn| рисовать чертить.
difekt| повреждать, портить.
dis| раз- (в разные стороны).
distil| дистилировать, очишать перегонкою.
distr| рассеивать, развлекать.
do. итак, же.
dorn| шип, колючка (у растений).
dot| давать в приданое.
  drink|ej| кабак, шинок.
dung| нанимать (кого-либо).




edif| назидать, поучать.
efik| действовать (оказывать действие).
egal| одинаковый, равный.
eksped| отправлять (экспедировать).
eksplod| взрываться.
ekstr| экстренный, чрезвычайный.

fajl| пилить напильником.
fak| отделение, отдел, отрасль.
falbal| фалбала, оборка.
fand| расплавлять, растоплять.
fantom| призрак, привидение.
felt| войлок, фетр.
ferm| закрывать.
filtr| цедить, фильтровать.
firm| прочный.
flar| нюхать, обонять.
fleg| ухаживать (за больными и т. п.).
flik| латать, делать заплаты, починать.
flirt| порхать, любезничать.
fokus| фокус оптический.
frakas| раздроблять.
furunk| чирей, фурункул.

gamaŝ| гамаша, гетры.
gazet| газета, журнал.
grimac| гримаса. ужимка.
gustum| пробовать на вкус, отведывать.
guvern| воспитывать, наставлять.

indulg| снисходить, прощать.
infuz| настаивать (настойку).
iniciat| быть инициатором, делать почин.
insid| строить козни, подстререгать.
insign| герб, значок.
instig| побуждать, подстрекать.



 
ĵongl| жонгликровать.

kan| тростник, камыш.
kapitulac| капитулировать, сдаться.
kapot| плащ с капюшоном.
kapuĉ| капюшон.
kaviar| икра (рыб, амфибий).
kaz| падеж (грамматич.).
ken| смолистое дерево (также-лучина).
kiras| панцырь, кираса.
kitel| китель, балахон.
kokcinel| божья коровка.
kolon| столб, колонна.
kolport| продавать в разнос.
komb| причесывать, чесать.
konjunkci| союз (грамматич.).
konsist| состоять.
konstat| подтверждать.
konvulsi| суддорога, конвульсия.
korpus| корпус (часть армии).
kost|o. стоимость.
kovril| (de libro) обложка, обёртка.
kramp| скоба, скобка.
kriminal| уголовный, криминальный.
kroĉ| зацеплять.
kronik| хроника, летопись.
krust| корка, струп.
kvazaŭ. как будто, будто-бы.
kviet| кроткий, спокойный.
kvitanc| выдавать квитанцию, расписываться в получении. 


led| кожа (выделанная).
leŭtenant| поручик, лейтенант.
liah| лиана.
litani| молебен.
lorn| зрительная труба.



maiz| маис, кукуриза.
mal| (приставка) означает прямую противоположность.

man| рука (кисть).
manier| способ, образ, манера.
markot| отпрыск, отросток.
met| поставить, положить, класть; может быть переведено различными глаголами.

mister| тайна.
murmur| бормотать.

nask|iĝ| рождаться (возникать).
not| (muzik|a) нота (музык.).

obstrukc| запор, засорение.
ol. чем (при сравнит. степени).

ole| масло (жидкое - раст., животн. и минеральное).
opini| иметь мнение, полагать.
ornam| украшать.

pantofl| туфля.
parti|a. пристрастный, партийный.
pentr| рисовать, писать красками.
petrol| керосин.
petrosel| петрушка (растение).
pik| колоть; пика (в картах).
pini| пиния.
pip| трубка (для курения).
precip| преимущественно, особенно.
primol| первозвет, баранчик.
pro. ради, из-за.
proces| прозесс.
profit| иметь барыш, воспользоваться.

proklam| оглашать, провозглашать, обнародовать.
prokrast| отсрочивать, откладывать.
prov| испывать, пробовать.

radi| луч, спица (колеса).
rafin| рафинировавать, жимически очищать, изощрять.
rand| край (граница).
rang| ранг, степень, чин.
rast| сгебать граблями.
restoraci| ресторан.
rezerv| приберечь, сохранить для себя, обеспечить за собою.

ribel| восставать, бунтовать.
rifuĝ| укрываться, находить убежище-
rikolt| жать (рожь, пшеницу).
riverence| реверанс, поклон.

sagac| хитрый, проницательный.
salut| кланятцся, приветствовать.
ŝat| дорожить, ценить.
sekret| тайна, секрет.
servut| барщина (крепостное право).
sibl| шипеть.
sincer| искренний
sinjor| господин, сударь.
skiz| делать очерк, эскиз, набросок.
sol| единственный, один.
solv| растворять в жидкости; решать задачу, загадку.
sopran| дискант, сопрано.
sorb| всасывать, хлебать.
spalir| шпалера.
spez| оборот (в торговле).
spit| вопреки, наперекор.
sput| харкать.
steb| строчить (шить).
strek| проводить черту, черкать.
strik| стачка, забастовка.
ŝuld| быть должным (должником).
sulk| борозда, морщина.



tali| стан, талия.
teg| натягивать (сверху), обтягивать.
teler| тарелка.
tem| тема.
teras| терраса.
tibi| большая берцовая кость.
torn| гочить (на токарном станке).
traĥe| дыхательное горло, трахея.
trajt| черта (лица, характера и пр.).
trakt| вести преговоры, трактовать.
tri|foli| трилисник, клевер.
trip| потроха, требуха, ливер.
trivial| избитый, пошлый, тривиальный.
tron| престол, трон.
trul| лопаточка для штукатуров.
tumult| суматоха, тревога.
turn| вращать, поворачивать.

uniform| форма, мундир.
universal| вцеобщий, универсальный.

uzurp| уаурпировать, беззаконно захватывать.

van| напрасный, тщетный.
vart| няньчить, ухаживать зя детьми.
veget| прозябать, произрастать.
ventr| живот.
verdigr| ярь, медяника.
verk| цочинять, писать (книги).
vestibl| сени, вестибюль.
veŝt| жилет.
vikari| викарий.
virg| девственный, невинный.

mal|virg|ig| лишать невинности, растлить.
viŝ| вытирать.



 
 

POLA PARTO /!?9

(Redaktita de A. GRABOWSKI kaj K. BEIN) (29)

absces|
absint|

mal afabl]
afer|
agac|
akir|
akuŝ|
alud|
aparten|
apog|
apr|
artifik|
artik |
av]

babil|
baldaŭ.
barakt|
barbir|
bet|
blat|

A

robien,

absynt.
opryskliwy.
Sprawa, Tzecz.
cierpnaĉ (zeby)
uzyskaĉ, zdobyĉ.

powiĉ, odbyĉ pol6g.

napomknaĉ. :
nalezeĉ (do kogo)
opieraĉ (0 co)
dzik.

fortel, sztuka.
staw (anat.).
dziadek.

B

paplaĉ, gawedziĉ.
wkrotce.
szamotaĉ sie,
balwierz.

burak.

karaluch.

 

blond|
brog|
bub|
bufed|

ĉan |
ĉarm |
ĉarnir|
ĉes|
ĉifon |
civiliz|
ĉiz|

dee|
deĉifr|

degel|
domaĝ|
dung|

blond, plowy.
oparzyĉ.

chlopak, ulicznik.
bufet.

ce

kurek (przy fuzji)
uroczy, mily.
szarnier.

przestaĉ.

szmata, lachman.
cywilizowaĉ.
dlutem obrabiaĉ.

D

byĉ przyzwoitym.

odczytaĉ, odcytro-
waĉ.

tajaĉ, odmarzaĉ.

szkoda, zal.

najmowaĉ (kogo)

(28) Th. CART (1928). — Ni ne modifis la intertempe ŝanĝiĝintan polan

ortografion (La malnovajn : emalja, misterjum, pinĵa..
emalia, misterium, pinia...). — Ni tie danku Inĝ. L

kontrolis la lastan presprovaĵon.

(29) La pola komisiono elektita de la L.K. en 1906 konsistis ĝuste el S-
K. BZIN (= KABE) kaj GRABOWSKI. sistis ĝuste el S-roj

278

. Poloj senpene legos :
„ ZAMENHOF, kiu bonvole

eben|
edif|
egal|
ekscit|
ekstr|
ekstrem|
ekzil|
el.
em] ... babi-
lem|
emajl|
embaras|
eŝafodl|

fabel|
fabl|
facet|

facil|
fak|
fam]
fantom]
fart|
fel|
ferdek|
figur|
flos|
fokus|
fos|
fost|
frand|
fripon |
fum |

furioz|
furunk|

E

rowny, plaski.
budowaĉ (moral.).
rowny, jednakowy.

podniecaĉ, wzburzyĉ.

nadzwyczajny.
skrajny, kraŭcowy.
wygnaĉ, zeslaĉ.
z (z dopetniaczem).

gadatliwy.
emalja.

ambaras, klopot.
szafot.

F

baŝn.

bajka.

graŭ, ŝcianka
szlifowana.

latwy.

przegrodka, dzial.

pogloska, wieŝĉ.

widmo, duch.

stan (zdrowia).

skora, futro.

poklad (okretu)..

wyobrazaĉ, poslaĉ.

tratwa.

ognisko (matemat.)

kopaĉ, ryĉ.

przywoj, stup. "

tasowaĉ.

szelma, lotr.

dymiĉ, paliĉ
(papierosy).

wŝciekty (z gniewu).

czyrak.

 

gajn |

ĝem|

gent|
glad|

glob|

graci |
gril|

hiskiam |
histrik|
kortulan|

ibis|
imag|
in|

indulg|
infuz|
insid |
instig|
instrukci |

insult |

ĵongl|

kaĉ|
kalfatr|
kanab|
kapitel|

GĜ

wygrywaĉ, zyskaĉ.
stekaĉ, jeczeĉ.
plemie, rod.
prasowaĉ (bielizne).
kula, glob.
wysmukly, zgrabny.
ŝwierszcz.

H

blekol.
jezozwierz.
poŝwierka, ortolan.

I

ibis.

wyobrazaĉ (sobie).

oznacza kobiete lub
samice.

oszezedzaĉ, poblazaĉ.

robiĉ nastoj. ;

robiĉ zasadzke.

pobudzaĉ (do czynu).

instrukcja, wska-
zOwka.

wymyŝlaĉ, zniec-
wazaĉ.

Ĵ

Zonglowaĉ, mamiĉ.

K

kasza (golowana).
utykaĉ szpary.
konopie.

kapitel, gtowica.

279

 

 

 
 

klopod|

kobold|
kokcinel|
kolon |
komand|
komfort |
komun]
kondamn |

konfes |
konfirm]

konjekt!

konsist|
konspir|
konstern |

konsum]

kontuz|
korn]
korpus|
kort|eg|

kraken|
krem]
kron |
kroz|
krud|
kugl|

280

szepleniĉ.

zamek (obronny).

wypalaĉ (medyc.)

przypadek (gramat.)

jadro, pestka.

tram, kil.

kirys, pancerz.

kitel.

jasny, klarowny.

wyksztalcony,
ŝwiatly.

czyniĉ zabiegi, staraĉ
sie.

kobold, krasnoludek.

biedronka.

slup, kolumna.

komenderowaĉ.

komfort, wygoda.

wspolny.

osadzaĉ, skazaĉ, po-
tepiaĉ.

wyznaĉ.

potwierdzaĉ,
zatwierdzaĉ.

domyŝlaĉ sie,
przypuszczaĉ.

skladaĉ sie (z czego).

spiskowaĉ,

konsternowaĉ,
przerazaĉ.

konsumowaĉ,
ZUZYwaĉ.

stlue, kontuzyowaĉ.

rog (zwierzecy).

korpus (armii)

dw6or (np. krolewski).

ciastko (suche).

ŝmietanka.

wieniec, korona.

krazyĉ (o okretach).

surowy (produkt).

kula (do strzelania).

 

kuk |
kukurb|
kup|

kur|
kvankam.
kvartal|
kviet|
kvit|

pri|labor|

laĉ|

lak|

lav

led|

leĝ|
leontod|

rd

lini|

liver|

log|
de|log|
lu|

luks|

mac|
mangan |
marĉ]

meĉ aĵ)
meriz|
met]

mev |

ciastko.

dynia.

baŭka (medyc.).
biegaĉ.

chociaz, pomimo ze.
dzielnica (miasta).
lagodny, spokojny.
kwita.

L

obrabiaĉ, opracowaĉ. 4

sznurek.

lakier.

myĉ, praĉ.

skora (wyrobiona).

prawo, ustawa.

Iwi zab (roŝlina).

wigzaĉ, lagezyĉ.

wiersz, linia.

dostawiaĉ, dostar-
czaĉ.

wabiĉ.

uwieŝĉ.

wynajmowaĉ (co od
kogo).

przepych.

M

przaŝny chleb, maca. |

mangan.

bagno, bloto.
lont.

dzika wiŝnia.
klaŝĉ ; moze byĉ

oddane za pomoca |

LA
JI

rozmaitych czaso- |

wnik6w.
mewa.

mien]

min|
mister|

muĝi

neces |
neniu.

persist |
piedestal|
pini|
pirit|
pist|
piŝt|
plad|
plaŭdl|
pli.
poent|
polur|
ponard|
posten |

predikat|

mina (wyraz
twarzy).
mina (podkop).
tajemnica,
misterjum.
huczeĉ, ryczeĉ.

N

potrzebny.
nikt, zaden.

0

obrazaĉ.
zaimek nieosobisty.
organy.

p

para (dwa).
przechodziĉ, mijaĉ.

ciasto (rozczynione).

gnaĉ, pedziĉ.

malowaĉ.

peron, ganek.

nalegaĉ, obstawaĉ.

piedestal.

pinja.

piryt.

tluc, rozdrabiaĉ.

tiok, kolba.

polmisek, miska.

pluskaĉ.

wiecej, bardziej.

oczko (w grze).

politura, polysk.

sztylet.

stanowisko,
posterunek.

orzeczenie (gram.).

 

prefer'|
preter.

pro.
profit|
progres|
prokrast|

promontor|
prosper

pugn|
pulv|
pus|

rajt|
raport|

rast|
reg|
regal|
region|
rempar|
rifuĝ|
riproĉ|

rond|
rukt|

rul|

ŝalm|
salut|

sambuk|
ŝancel|
mal [ŝat |

przekladaĉ, woleĉ.

mimo, obok.

z powodu, dla.

mieĉ korzyŝĉ,
zyskaĉ.

robiĉ postepy.

odktadaĉ, zwl6ezyĉ.

przyladek.

udaĉ sie, powodziĉ
sie.

kulak, pieŝĉ.

proch (strzelniczy).

ropa, materya.

R

prawo (mieĉ prawo).

zdawaĉ sprawe, mel-
dowaĉ.

grabiĉ (np.siano).

rzadziĉ, panowaĉ.

czestowaĉ, ugoŝciĉ.

okreg, okolica.

wat, okop.

schroniĉ sie.

zarzucaĉ, robiĉ
wyrzuty.

kolo, krag.

odbijanie (o
jedzeniu).

toczyĉ, kulaĉ.

S, Ŝ

fujarka.

klaniaĉ sie, pozdra-
wiaĉ.

bez groniasty.

chwiaĉ.

mieĉ za nic
(lekcewazyĉ).

281

 

 

 
satur|
sav|
sekv|

 

ŝel|
sepi|
serioz
signif|

ŝink |
ŝirm|
skabi|
sol|
sonor |
sopir|
sorb|
ŝovel|
ŝpruec|
stabl|
standard|
steb|
sterk |
stern |
stup|
sulfur|
ŝultr|
re|sum |
super.
ŝvel|

taĉment |
ted|

tem |
tenden |

282

nasycaĉ.

ratowaĉ, zbawiaĉ.

nastapiĉ, iŝĉ za kim,
wynikaĉ.

skorupa, lupina, kora.

sepja, plaw morski.

powazny, na serjo.

oznaczaĉ, mieĉ
znaczenie.

szynka.

zaslaniaĉ, chroniĉ.

ŝwierzba.

jedyny, sam.

dzwoniĉ, brzeczeĉ.

teskniĉ, wzdychaĉ.

chlipaĉ, wchlaniaĉ.

szuflowaĉ.

tryskaĉ.

warsztat.

sztandar.

stebnowaĉ.

gnoj, nawo0z.

slaĉ, rozŝcielaĉ.

pakuly.

siarka.

ramic, barki.

streŝciĉ.

nad, ponad.

puchnaĉ, nabrzmie-
wul,

X

vddziat (wojska).
nuprzykrzaĉ.
temat.

ŝciegno, cigeciwa.

 

ter|kol|
testik|
toler|
tord|
torn |
trik |
tro.
tromb|
trud|
tuber|
tumult|
turn |
turt|

vant|
vapor
vart|
ve!
vent|um]|
verdigr|
vers|
vertebr|
vet|
vie|
vigl|
vind|
vizier |
volv|
vual|

zebr|
zum |

przesmyk.

jadro.

tolerowaĉ, znosiĉ.
kreciĉ (np.powro0z).

toczyĉ (na tokarni).

robiĉ (na drutach).
zbyt, za, zanadto.
traba (morska).

narzucaĉ (co komu).

guz, sek.

zamieszanie, tumult.

obracaĉ, kreciĉ.
turkawka.,

Nu

VV
marny, prozny.
para (wodna).

piastowaĉ, niaŭczyĉ.

biada ! niestety !
wachlowaĉ.
grynszpan.

wiersz (poetycki).
kreg (anat.).
zatozyĉ sie (o co).
rzad, kolej, szereg.
ezujny, rzeZwy.

powijaĉ (w pieluchy).

przytbica.
wiĉ, zawijaĉ.
wual, zastona.

Z
zebra.

brzeczeĉ (o
owadach).

P.S. — Pri la vortoj « gargari » kaj « malsobra », kies polaj tra-
dukoj laŭ mia opinio estas ĝustaj, Kolego BEIN rezervis al si « vo-
tum separatum » (80).

A. Gx.

Pri la vortoj : « gargari », « sobra », « malsobra »

Gargari (81)

Mi proponas :

Gargari. — Se gargariser | to gargle| gurgeln [uonocxar» (ropao))|
plukaĉ (gardto); t. e. oni povas diri gargari nur pri la gorĝo; gar-
gari tolaĵon estas tute malĝusta esprimo, la ĝusta vorto mankas en
Esperanto (81), gargari ne povas ĝin anstataŭi, ĉar alie la multe-
nacia, son-imitanta vorto gargar signifus tion, kion ĝi signifas en
neniu lingvo. Eĉ en arta lingvo la arbitreco devas havi limojn, kaj
ni forgesu neniam, ke la principo de l'internacieco devas superi
ĉiujn aliajn.

Sobra, malsobra (81)

Mi proponas :
Sobra. — Wstrzemiezliwy, umiarkowany.
Malsobra. — Niewstrzemiezliwy, nieumiarkowany ; t.e. la

sencon, kiun oni donis al la vortoj en la aprobitaj vortaroj (82).
Akceptinte la vorton ebria, D-ro ZAMENHOF mem ŝanĝis la signifon
de la cititaj vortoj.

Varsovio, 14 JUL 07.
D-ro BEIN.

(830) Latine : aparta voĉdono.

(31) Vd. klarigojn en la Lingvaj Rimarkoj.

(32) Aprobitaj vortaroj : D£ BEAUFRONT (1902) : intempĉrant. — Jun-
GENSEN (1904) : unmissig. (Laŭ KABE, 1911 : malsobra = malmodere trin-
kanta kaj manĝanta ; ebria = estanta sub la influo de la alkoholo. — En la
F-to, malsobra havis la signifon de ebria).

 

 

 

